1111111111111
100000C0000C1
1C00011111101
1P0011001E101
1111111111111