1111111111111
100000C0001C1
1C00011110011
1P0011000E001
1111111111111