1111111111111
101000C0000C1
1C10011111001
1P1011000E001
1111111111111