1111111111111111111
1P00000000000000001
10CC00CC000CCCCCC01
10CC00CC0000000CC01
10CC00CC0000000CC01
10CCCCCC00000CCCC01
100CCCCC000CC000001
100000CC000CC000001
100000CC000CCCCCC01
11111111111111111E1
1111000001111111111
