1111111111111111111
1000000000000000001
10CC00CC000CCCCCC01
10CC00CC0000000CC01
10CC00CC0000000CC01
10CCCCCC0P00CCCCC01
100CCCCC000CC000001
100000CC000CC000001
100000CC000CCCCCC01
10000000000000000E1
1111111111111111111
